42
21
21 21 21 21 21 21 21 21 21 21 21 21 21 21 21 21 21 21 21 21 21 21 21 21 21 21 21 21 21 21 21 21 21 21 21 21 21 21 21 21 21 21 
21 21 0 0 0 0 0 0 1 21 21 21 21 21 21 21 21 21 21 21 21 21 0 0 0 0 0 0 0 0 0 0 0 0 21 21 21 21 21 21 24 21 
21 0 0 0 0 0 0 0 1 21 21 21 21 21 21 21 21 0 0 0 0 0 0 0 0 0 0 0 0 0 0 0 0 0 0 0 0 0 0 23 24 24 
21 0 0 0 0 0 21 21 21 21 21 21 21 0 0 0 0 0 0 0 0 0 0 0 0 0 0 0 0 0 0 0 0 0 0 0 0 0 0 0 23 24 
21 21 0 0 0 0 0 21 0 0 0 0 0 0 0 0 0 0 0 0 0 0 0 0 0 0 0 0 22 22 22 0 0 0 0 0 0 0 0 0 23 24 
23 21 21 0 0 0 0 0 0 0 0 0 0 0 0 0 0 0 22 22 22 22 22 22 22 22 22 22 21 23 23 0 21 0 0 0 0 0 0 23 23 24 
23 21 21 21 0 21 0 0 0 0 0 0 0 0 0 0 22 22 33 23 23 23 23 23 23 23 23 23 23 23 23 0 0 0 0 0 0 0 23 23 21 24 
23 21 21 7 0 0 0 0 0 21 0 0 21 21 21 22 33 23 23 23 23 23 23 23 23 23 0 23 23 23 0 0 0 0 0 23 23 23 21 21 21 21 
23 21 21 7 0 0 0 0 0 0 0 0 0 0 21 21 21 21 21 21 23 0 23 23 23 0 0 0 0 0 0 0 0 0 0 21 21 21 21 21 21 21 
23 21 21 21 22 22 22 0 0 0 0 0 0 0 0 21 21 21 21 21 21 0 0 23 0 0 0 0 0 0 0 0 0 22 22 21 21 21 21 21 21 21 
23 21 21 21 21 21 0 0 0 0 0 0 0 21 21 21 21 21 21 21 21 0 0 0 0 0 0 0 0 0 0 0 0 21 21 21 21 0 0 21 21 21 
23 21 21 21 21 21 0 0 21 0 0 0 0 21 21 21 0 21 21 21 21 0 0 0 0 0 0 0 0 0 0 0 22 21 21 21 0 0 0 0 21 21 
23 21 21 0 0 21 0 0 0 0 0 0 21 21 21 21 0 21 21 21 0 0 0 0 0 0 0 0 22 22 22 22 21 21 21 0 0 0 0 0 21 21 
23 21 0 0 0 0 0 0 0 0 21 21 21 21 0 0 0 0 0 21 21 0 0 0 0 0 22 22 21 21 21 21 21 21 21 0 0 0 0 0 21 21 
24 0 0 0 0 0 0 0 0 21 21 21 0 0 0 0 0 0 0 0 21 0 0 0 0 0 0 0 0 21 21 21 0 0 0 0 0 0 0 0 6 21 
24 24 0 0 0 0 0 0 0 0 0 0 0 0 0 0 0 0 0 0 21 21 0 0 0 0 0 0 0 0 0 0 0 0 0 0 0 0 0 0 6 21 
23 0 0 0 0 0 0 23 23 0 0 0 0 0 0 0 0 23 24 23 23 21 21 9 9 9 9 9 9 9 9 9 9 9 9 9 9 9 22 22 21 21 
23 0 0 0 24 0 0 0 23 23 0 0 23 23 23 24 23 23 23 23 23 23 21 10 10 10 10 10 10 10 10 10 10 10 10 10 10 21 21 21 24 23 
24 24 23 23 23 23 23 23 23 23 23 23 23 23 23 23 23 24 23 23 23 23 23 23 23 23 23 23 23 23 23 23 23 23 23 23 23 23 21 23 23 24 
23 23 23 23 23 23 23 23 24 23 23 23 23 23 23 23 24 24 24 24 23 23 23 23 23 23 23 23 24 24 23 23 23 23 23 23 23 23 23 23 23 23 
23 24 23 24 24 24 24 24 23 23 23 23 23 23 23 23 23 23 23 23 23 23 23 23 23 23 23 23 23 24 24 24 24 23 23 23 23 23 23 23 23 23 
