41
29
23 24 21 21 21 21 21 21 21 21 21 21 21 21 21 21 21 21 21 21 21 21 21 21 21 21 21 21 21 21 21 21 21 21 21 21 21 21 23 24 23 
24 21 0 0 0 0 0 0 0 0 0 0 0 0 5 5 5 5 5 5 5 5 5 0 0 0 0 0 0 0 0 21 21 21 21 21 21 21 21 24 23 
23 21 0 0 0 0 0 0 0 0 0 21 21 21 21 21 23 23 21 21 21 21 21 0 0 0 0 0 0 0 0 0 0 21 21 21 21 21 21 21 24 
21 21 0 0 0 0 22 22 22 22 22 21 21 21 21 23 23 21 21 21 21 21 21 22 22 22 22 22 22 0 0 0 0 0 0 0 0 0 0 21 23 
21 21 0 0 0 21 21 21 21 21 21 21 21 21 23 23 23 23 21 21 21 23 21 21 21 21 21 21 21 21 21 0 0 0 0 0 0 0 0 0 23 
23 21 0 21 21 21 21 21 21 21 21 0 0 21 21 23 23 23 0 0 21 21 21 21 0 0 21 0 0 0 0 0 0 0 23 0 0 0 0 0 23 
23 24 21 21 21 21 21 21 21 0 0 0 0 0 21 0 23 23 23 0 0 0 0 0 0 0 0 0 0 0 0 0 0 23 23 23 23 23 0 0 23 
23 23 23 21 21 21 0 0 21 0 0 0 0 0 0 0 0 23 0 0 0 0 0 0 0 0 0 0 0 0 0 0 0 0 0 23 23 23 23 23 24 
23 23 21 21 21 0 0 0 0 0 0 0 0 0 0 0 0 0 0 0 0 0 21 21 21 21 21 21 21 21 21 21 0 0 0 0 0 0 0 23 23 
23 23 21 21 21 7 0 0 0 0 0 0 0 0 0 0 0 0 0 0 0 21 21 21 21 21 21 21 21 21 21 21 21 0 0 0 0 0 0 0 23 
23 21 21 21 21 7 0 0 0 0 0 0 0 0 0 0 0 0 21 21 21 21 21 21 0 21 21 21 21 21 21 21 0 21 21 0 0 21 21 0 23 
23 21 21 21 21 21 22 22 22 22 22 22 0 0 0 0 0 0 0 0 0 0 21 21 0 0 21 21 21 0 0 0 0 0 0 0 0 0 21 21 24 
23 9 21 23 23 23 0 0 0 0 0 0 22 22 22 22 22 0 0 0 0 0 21 0 0 0 0 0 21 0 0 0 0 0 0 0 0 6 21 21 23 
23 10 23 23 0 0 0 0 0 0 0 0 0 0 0 0 0 23 23 0 0 0 0 0 0 0 0 0 0 0 0 0 0 0 0 0 0 6 21 21 23 
24 10 0 0 0 0 0 0 23 24 23 23 23 0 0 0 0 0 23 24 24 0 0 0 0 0 0 0 0 0 0 0 22 22 22 22 22 21 21 21 23 
24 10 0 0 0 0 0 23 23 23 23 23 23 24 23 23 0 0 0 23 23 23 23 0 0 0 0 0 0 0 0 21 21 21 21 21 23 23 24 24 23 
23 10 0 0 0 0 23 23 0 23 0 23 23 0 0 0 0 0 0 0 23 23 24 23 0 0 0 0 21 21 21 21 21 21 0 0 0 0 0 0 23 
23 10 23 23 0 0 0 0 0 23 0 0 0 0 0 0 0 0 0 0 0 0 0 23 23 0 0 0 0 0 0 21 21 0 0 0 0 0 0 0 24 
23 10 23 23 0 0 0 0 0 0 0 0 0 0 0 0 23 23 23 23 0 0 0 0 0 0 0 0 0 0 0 0 0 0 0 0 0 23 23 24 23 
23 10 0 23 24 23 0 23 23 23 23 24 23 23 23 23 23 0 0 0 0 0 0 0 0 0 21 21 0 0 0 0 0 0 21 21 0 23 24 23 23 
23 10 0 0 23 23 23 23 23 23 23 23 23 23 23 23 0 0 0 0 0 0 0 0 0 24 23 21 21 0 0 0 0 21 21 21 0 0 0 23 23 
23 10 9 0 0 23 23 23 23 24 23 23 23 23 23 0 0 0 0 0 0 0 0 23 23 24 23 24 21 21 0 0 0 0 21 0 0 0 0 23 23 
24 23 10 0 0 0 23 0 0 24 24 23 0 0 0 0 0 0 0 0 23 24 24 23 23 23 23 23 21 21 22 22 0 0 0 0 0 0 0 0 23 
23 23 10 9 0 0 0 0 0 0 23 0 0 0 0 0 0 0 0 0 0 0 23 23 23 0 23 0 21 21 0 0 0 0 0 0 0 0 0 0 23 
23 23 23 10 9 0 0 0 0 0 0 0 0 0 0 23 23 23 23 24 0 0 0 0 0 0 0 0 0 0 0 0 0 0 0 0 23 23 23 23 24 
24 24 23 23 10 9 23 0 0 0 0 0 24 23 23 24 23 24 23 23 23 23 0 0 0 0 0 0 0 0 0 0 21 21 21 23 23 23 23 24 24 
23 23 24 23 23 23 23 23 24 23 23 23 23 23 23 23 23 24 24 23 23 23 23 23 23 21 22 22 22 22 22 22 21 23 24 24 23 23 23 23 23 
23 23 23 23 23 23 23 23 23 24 23 23 23 23 23 23 23 23 23 23 23 23 21 21 21 21 21 21 24 21 21 21 21 23 23 23 23 23 23 23 23 
23 23 23 23 24 24 23 23 23 23 23 23 23 23 23 23 23 23 23 23 23 21 21 21 21 21 24 23 24 21 23 21 21 21 23 23 23 23 23 24 23 
