22
18
23 23 23 23 23 23 23 23 23 23 23 23 23 23 23 23 23 23 23 23 23 23 
23 23 23 23 23 23 0 0 23 23 23 0 0 23 0 0 0 23 23 23 23 23 
23 23 23 23 23 0 0 0 0 0 0 0 0 0 0 0 0 0 0 0 23 23 
23 23 23 0 23 0 0 0 0 0 0 0 0 0 0 23 23 0 0 0 0 23 
23 23 0 0 23 0 0 0 3 22 22 28 23 23 23 23 23 23 0 0 0 23 
24 23 0 0 0 0 3 22 22 26 2 0 0 0 0 0 0 23 23 0 0 23 
21 0 0 0 0 1 21 21 2 0 0 0 23 23 23 0 0 0 23 0 0 23 
7 0 0 3 22 22 4 0 0 0 0 23 23 23 0 0 0 0 0 0 0 23 
7 0 0 0 0 0 0 0 0 23 23 23 23 0 0 0 23 0 0 0 23 23 
22 22 4 0 0 0 0 0 0 0 0 0 0 0 0 0 0 0 0 0 23 23 
21 21 0 0 0 23 23 23 0 0 0 0 0 0 0 0 0 0 0 0 0 23 
21 21 0 0 0 0 0 0 0 23 0 0 0 0 23 23 23 23 0 0 0 23 
21 21 21 0 0 0 0 0 0 0 0 0 0 0 0 0 0 0 0 0 0 6 
21 21 21 21 0 0 0 0 0 0 23 23 0 0 0 0 0 0 0 0 0 6 
21 21 21 21 21 0 0 0 0 0 0 0 0 0 0 0 0 0 0 3 22 22 
21 21 0 0 0 0 0 3 22 4 0 0 3 22 22 4 0 0 1 33 32 32 
21 0 0 0 0 0 0 0 0 0 3 22 22 28 24 27 22 22 28 23 24 24 
21 21 21 21 24 24 24 27 22 22 22 28 24 24 24 23 23 23 24 24 24 24 
