22
13
21 21 21 21 23 21 23 23 23 23 23 23 23 23 23 23 23 23 23 23 23 23 
21 0 0 0 23 23 23 0 0 0 23 23 23 23 23 23 23 23 23 0 0 23 
21 0 0 0 23 23 0 0 0 0 23 23 0 23 23 23 0 0 0 0 0 23 
21 22 0 0 0 0 0 0 0 0 0 23 0 0 23 23 0 0 0 0 0 23 
32 0 0 0 0 0 0 0 0 0 0 23 0 0 0 23 23 0 0 0 0 23 
21 0 0 0 23 23 0 0 0 0 0 0 0 0 0 0 0 0 0 0 0 23 
7 0 0 0 0 0 0 0 0 0 0 0 0 0 0 0 0 0 0 0 23 23 
7 0 0 0 0 0 0 23 23 0 0 0 0 0 0 0 0 0 23 23 23 23 
22 22 0 0 0 0 0 0 0 0 0 0 0 0 0 0 0 0 0 0 0 23 
21 0 0 0 0 0 0 0 0 23 0 0 0 23 23 0 0 0 0 0 0 23 
21 0 0 0 0 0 23 0 23 23 0 0 0 0 0 0 0 0 0 0 0 6 
21 22 22 22 28 23 23 24 24 23 23 23 0 0 0 0 0 0 0 0 0 6 
21 21 21 23 23 24 24 24 24 23 23 23 23 24 29 22 22 22 22 22 22 22 
