113
41
23 23 23 23 23 23 23 23 23 23 23 23 23 23 23 23 23 23 23 23 23 23 23 23 23 23 23 23 23 23 23 23 23 23 23 23 23 23 23 23 23 23 23 23 23 23 23 23 23 23 23 23 23 23 23 23 23 23 23 23 23 23 23 23 23 23 23 23 23 23 23 23 23 23 23 23 23 23 23 23 23 23 23 23 23 23 23 23 23 23 23 23 23 23 23 23 23 23 23 23 23 23 23 23 23 23 23 23 23 23 23 23 23 
23 23 23 0 0 23 23 23 0 0 0 23 23 23 23 23 0 0 0 0 0 0 23 23 23 0 0 0 0 23 23 23 0 0 0 0 0 23 23 23 0 0 0 0 23 23 23 23 23 23 23 0 0 23 23 23 23 23 0 23 23 0 0 0 0 23 23 23 23 23 23 23 23 23 23 0 0 23 23 23 23 23 0 0 0 0 0 23 23 23 0 0 0 0 0 0 0 0 0 23 23 23 23 23 23 23 23 23 23 23 23 23 23 
23 23 0 0 0 0 23 23 0 0 0 0 23 23 0 0 0 0 0 0 0 0 23 23 23 0 0 0 0 0 23 23 0 0 0 0 0 0 0 0 0 0 0 0 0 0 23 23 0 23 0 0 0 0 23 23 23 0 0 23 0 0 0 0 0 23 23 0 0 23 23 0 23 23 0 0 0 0 0 23 23 23 0 0 0 0 0 0 23 23 0 0 0 0 0 0 0 0 0 0 0 23 23 23 23 23 23 23 23 23 23 23 23 
23 23 0 0 0 0 23 0 0 0 0 0 23 23 0 0 0 0 0 0 0 0 0 23 23 0 0 0 0 0 23 0 0 0 0 0 0 0 0 0 0 0 0 0 0 0 23 0 0 23 0 0 0 0 23 23 23 0 0 23 0 0 0 23 0 0 23 0 0 0 0 0 0 0 0 0 0 0 0 23 23 0 0 0 0 0 0 0 23 0 0 23 23 23 0 0 0 0 0 0 0 0 0 23 23 23 23 23 23 23 23 23 23 
23 23 0 0 0 0 0 0 0 0 0 0 23 0 0 0 0 0 0 0 0 0 0 23 23 0 0 0 0 0 0 0 0 0 0 0 0 0 0 0 0 0 0 0 0 0 0 0 0 23 0 0 0 0 0 23 23 0 0 0 0 0 0 23 0 0 0 0 23 23 23 23 23 0 0 0 0 0 0 0 0 0 0 0 0 0 0 0 23 0 0 0 0 0 0 0 0 0 0 0 0 0 0 0 23 23 23 23 23 23 23 23 23 
23 0 0 0 0 0 0 0 0 0 0 0 0 0 0 0 0 0 0 0 0 0 0 23 23 0 0 0 0 0 0 0 0 0 0 0 0 0 0 0 0 0 0 0 0 0 0 0 0 0 0 0 0 0 0 23 23 0 0 0 0 0 0 23 23 0 0 23 23 23 23 23 23 23 23 0 0 0 0 0 0 0 0 0 0 0 0 0 0 0 0 0 0 0 0 0 0 23 23 23 0 0 0 0 23 23 23 23 23 23 23 23 23 
23 0 0 0 0 0 0 0 0 0 0 0 0 0 0 0 0 0 0 0 0 0 0 23 0 0 0 0 0 0 0 0 0 0 0 0 0 3 22 22 22 22 4 0 0 0 0 0 0 0 0 0 0 0 0 23 0 0 0 0 0 0 0 23 23 0 23 23 23 23 0 0 0 0 0 23 0 0 0 0 0 0 0 0 0 0 0 0 0 0 0 0 0 0 0 23 23 0 0 0 0 0 0 0 23 23 23 23 23 23 23 23 23 
23 0 0 0 22 22 0 0 0 0 0 0 0 0 0 0 0 0 0 0 0 0 0 0 0 0 0 0 0 0 0 0 0 0 0 0 0 22 26 21 21 25 22 21 0 0 0 0 0 0 0 0 0 0 0 0 0 0 0 0 0 0 23 23 23 23 23 0 0 23 0 0 0 0 0 0 0 0 0 0 0 0 0 0 0 0 0 0 0 0 0 0 0 0 0 0 0 0 0 0 0 0 0 0 23 23 23 23 23 23 23 23 23 
23 0 0 0 0 0 0 0 0 0 0 0 23 23 23 0 0 0 0 0 0 0 0 0 0 0 0 0 0 0 0 0 0 0 0 0 0 21 21 21 0 21 21 21 21 21 0 0 0 0 0 23 23 0 0 0 0 0 0 0 0 0 23 23 23 23 0 0 0 0 0 0 0 0 0 0 0 0 23 23 0 0 0 3 22 22 22 22 4 0 0 23 23 0 0 0 0 0 0 0 0 0 0 0 23 23 23 23 23 23 23 23 23 
7 0 0 0 0 0 0 0 0 0 23 23 23 23 0 0 0 0 23 23 0 0 23 23 0 0 0 0 0 0 0 0 0 0 0 0 0 0 21 21 0 21 0 0 0 0 0 0 0 0 0 23 23 23 0 0 0 0 0 0 0 0 23 23 0 0 0 0 0 0 0 23 23 23 23 0 0 0 0 0 0 3 22 22 26 21 21 2 0 0 0 0 0 0 0 0 0 0 0 0 0 0 0 0 23 23 23 23 23 23 23 23 23 
7 0 0 0 0 0 0 23 23 23 23 0 0 0 0 0 0 23 23 0 0 0 0 0 0 0 0 0 0 0 0 0 0 0 0 0 0 0 21 0 0 0 0 0 0 0 0 0 0 0 0 0 0 0 0 23 23 23 23 0 0 0 0 0 0 0 0 0 0 0 23 23 24 24 23 23 0 0 0 0 0 0 0 0 0 0 0 0 0 0 0 0 0 0 0 3 22 22 22 22 4 0 0 0 0 23 23 23 23 23 0 0 23 
22 22 4 0 0 0 0 0 0 0 0 0 0 0 0 0 0 0 0 0 0 0 0 0 0 0 0 0 0 0 0 0 0 0 0 0 0 0 0 0 0 0 0 0 0 0 0 0 0 0 0 0 0 0 0 0 23 23 23 23 0 0 0 0 0 0 0 0 0 23 23 24 24 24 24 23 23 0 0 0 0 0 0 0 0 0 0 0 0 0 0 0 0 0 3 22 21 21 21 21 0 0 0 0 0 23 23 23 23 0 0 0 23 
23 23 23 0 0 0 0 0 0 0 0 0 0 0 0 0 0 0 0 0 0 0 0 0 0 0 0 0 0 0 0 0 0 0 0 0 0 0 0 0 0 0 0 0 0 0 0 0 0 0 0 0 0 0 0 0 0 23 0 0 0 0 0 0 0 0 0 0 0 23 24 24 24 23 24 24 27 22 22 22 22 22 22 22 22 22 4 0 0 0 0 3 22 22 22 21 21 0 0 21 0 0 0 0 0 23 0 0 0 0 0 0 23 
23 23 23 23 0 0 0 0 0 0 0 0 0 0 0 0 0 0 0 0 0 0 0 0 0 0 0 0 0 0 0 0 0 0 0 0 0 0 0 0 0 0 0 0 0 0 0 0 0 0 0 0 0 0 0 0 0 0 0 0 0 0 23 23 0 0 0 0 23 23 24 24 23 23 24 24 24 21 21 21 21 21 21 21 21 21 22 22 22 22 22 22 21 21 21 0 0 0 0 21 0 0 0 23 23 23 0 0 0 0 0 0 23 
23 23 23 23 23 0 0 0 0 0 0 0 0 0 0 0 0 0 0 0 0 0 0 0 0 0 0 0 0 0 0 0 0 0 0 0 0 0 0 0 0 0 0 0 0 0 0 0 0 0 0 0 0 0 0 0 0 0 0 0 0 23 23 23 23 23 23 23 23 23 24 23 23 24 24 24 24 21 21 21 21 21 21 21 23 21 21 21 21 21 21 21 21 0 21 0 0 0 21 21 0 0 23 23 0 0 0 0 0 0 0 0 23 
23 23 23 23 23 23 23 23 23 24 0 0 0 0 0 0 0 0 0 0 0 0 0 0 0 0 0 0 0 0 0 0 0 0 0 0 0 0 0 0 0 0 0 0 0 0 0 0 0 0 0 0 0 0 0 0 0 0 0 0 0 0 0 0 23 23 24 24 24 24 23 23 23 23 24 24 24 24 21 21 21 21 21 21 23 23 21 21 23 23 21 21 21 0 21 0 0 0 21 0 0 0 0 0 0 0 0 0 0 0 0 0 23 
23 23 23 23 23 23 23 23 23 24 23 23 24 24 23 23 23 22 22 22 22 9 9 9 9 9 9 9 9 9 9 9 22 22 22 22 9 9 9 9 9 9 9 9 9 9 9 9 9 9 9 9 9 22 22 22 22 22 22 0 0 0 0 0 0 23 23 24 24 24 23 23 23 23 24 24 24 21 21 24 21 21 21 23 23 23 21 21 0 23 0 21 0 0 0 0 0 0 0 0 0 0 0 0 0 0 0 0 0 0 0 0 23 
23 23 23 23 10 10 10 23 23 24 24 23 23 23 24 23 23 23 23 23 21 10 10 10 10 10 10 10 10 10 10 21 21 21 21 21 21 10 10 10 10 10 10 10 10 10 10 10 10 10 10 21 21 21 23 23 23 23 23 23 23 0 0 0 0 0 23 23 23 23 23 23 23 23 24 21 21 21 24 24 21 21 23 23 23 0 21 0 0 23 0 21 0 0 0 0 0 0 0 0 0 0 0 0 0 0 0 0 0 0 0 0 6 
23 24 24 24 10 10 10 10 10 10 10 10 10 10 24 23 23 23 23 21 10 10 10 10 10 10 10 10 10 21 21 21 21 21 21 21 10 10 10 10 10 10 10 10 10 10 10 10 10 10 21 21 23 23 23 23 23 23 23 23 23 23 0 0 0 0 0 23 23 23 23 23 23 24 24 24 24 24 24 21 21 23 23 23 23 0 21 0 0 23 0 21 0 0 0 0 0 0 0 0 0 0 0 0 0 0 0 0 0 0 0 0 6 
23 23 23 24 10 10 10 10 10 10 10 23 24 23 23 23 23 23 21 10 10 10 10 10 10 10 10 10 10 10 10 21 21 21 21 10 10 10 10 10 10 10 10 10 10 10 21 21 21 21 21 23 23 24 24 23 23 23 23 23 23 23 23 0 0 0 0 0 0 23 23 23 23 24 24 24 24 24 24 21 0 0 0 0 23 0 0 0 0 23 0 0 0 0 0 0 0 0 0 0 0 0 0 0 0 0 0 3 22 22 22 22 22 
23 23 23 10 10 10 10 23 23 23 23 24 24 23 23 23 23 21 10 10 10 10 10 10 10 10 10 10 10 10 10 10 10 10 10 10 10 10 10 10 10 10 10 10 10 21 21 23 23 23 23 23 23 24 23 24 24 23 23 23 24 24 23 23 23 0 0 0 0 0 23 23 23 23 24 24 24 24 23 23 0 0 0 0 0 0 0 0 0 0 0 0 0 0 0 0 0 3 22 22 22 22 22 22 4 3 22 22 26 21 2 0 23 
23 23 23 10 10 10 23 23 24 24 24 23 23 23 23 23 21 10 10 10 10 10 10 10 10 10 10 10 10 10 10 10 10 10 10 10 10 10 10 10 10 10 10 10 10 21 24 24 24 23 23 23 23 24 24 24 24 23 23 23 23 24 24 23 23 23 0 0 0 0 23 23 23 23 23 23 23 23 23 0 0 0 0 0 0 0 0 0 0 0 0 23 23 0 0 0 0 0 21 21 21 21 21 21 0 0 21 21 21 21 0 0 23 
23 23 10 10 10 23 24 24 24 23 23 23 23 23 21 21 10 10 10 10 10 10 10 10 10 10 10 10 10 10 10 10 10 10 10 10 10 10 10 10 10 10 10 21 21 21 23 24 24 24 24 23 23 23 23 23 23 23 23 24 24 24 24 23 23 23 0 0 0 23 23 23 23 23 23 23 23 23 0 0 0 0 0 0 0 0 0 0 0 0 0 0 0 0 0 0 0 0 21 21 21 21 21 0 0 0 0 21 21 0 0 0 23 
23 23 10 10 24 23 24 23 23 23 23 23 23 21 10 10 10 10 10 10 10 10 10 10 10 10 10 10 10 10 10 10 10 10 10 10 10 10 10 10 21 21 21 21 23 23 23 24 24 23 24 23 23 23 23 23 23 23 24 24 24 24 23 23 23 23 23 0 0 0 0 0 23 23 23 23 23 23 23 0 0 0 0 3 22 22 22 4 0 0 0 0 0 0 0 0 0 0 21 21 21 21 21 0 0 0 0 21 21 0 0 0 23 
23 23 23 24 23 23 23 23 23 23 23 23 21 21 10 10 10 10 10 10 10 10 10 10 10 10 10 10 10 10 10 10 10 10 10 21 21 21 21 21 21 23 23 23 23 23 0 23 24 23 23 23 0 0 0 23 23 23 23 23 23 23 23 23 0 0 0 0 0 0 0 0 0 0 23 23 23 23 23 23 0 0 0 0 0 1 21 21 2 0 0 3 22 22 22 22 22 26 21 21 21 21 0 0 0 0 0 21 21 0 0 23 23 
23 23 24 24 24 23 23 23 23 23 23 23 21 21 10 10 10 10 10 10 10 10 10 10 10 10 10 10 10 10 10 10 10 10 10 21 23 23 23 23 23 23 23 23 23 0 0 0 24 23 0 0 0 0 0 0 23 23 23 23 0 0 0 0 0 0 0 0 0 23 0 0 0 0 0 0 0 23 23 23 23 23 0 0 0 0 0 0 0 0 0 0 0 0 21 21 21 21 21 21 21 21 0 0 0 0 0 0 21 0 0 23 23 
23 23 23 23 24 23 23 23 24 24 24 21 21 10 10 10 10 10 10 10 10 10 10 10 10 10 10 10 10 10 10 10 10 21 21 21 23 23 23 23 23 0 0 0 0 0 0 0 23 23 0 0 0 0 0 0 0 0 0 0 0 0 0 0 0 0 0 0 0 0 0 0 0 0 0 0 0 0 0 0 0 0 0 0 0 0 0 0 0 0 0 0 0 0 0 21 21 21 21 0 21 0 0 0 0 0 0 0 21 0 0 23 23 
23 23 23 23 24 23 23 23 23 23 24 21 21 10 10 10 10 10 10 10 10 21 21 21 21 21 10 10 10 21 21 21 21 21 23 23 23 23 23 0 0 0 0 0 0 0 0 0 0 23 0 0 0 0 0 0 0 0 0 0 0 0 23 23 24 23 23 23 23 23 23 23 23 0 0 0 0 0 0 0 0 0 0 0 0 0 0 0 0 24 0 0 0 0 0 0 21 21 0 0 21 0 0 0 0 0 0 0 0 0 0 23 23 
23 23 23 24 24 23 23 23 23 23 23 21 21 21 10 10 10 10 10 21 21 21 21 23 21 21 10 10 10 21 23 23 23 23 24 24 24 23 23 23 23 23 0 0 0 0 0 0 0 0 0 0 0 0 0 0 0 0 0 0 23 23 23 24 24 23 23 23 23 23 23 23 23 23 23 0 0 0 0 0 0 0 23 27 22 22 22 22 22 24 0 0 0 0 0 0 21 0 0 0 0 0 0 0 0 21 0 0 0 0 0 23 23 
23 23 23 23 23 23 23 23 23 23 23 21 21 21 21 21 21 21 21 21 23 23 23 23 23 21 10 10 10 21 23 23 23 24 24 23 23 23 23 23 23 23 0 0 0 0 0 0 0 0 0 0 0 0 0 0 0 0 23 23 23 23 23 23 23 0 0 23 23 23 23 23 23 23 23 23 23 0 0 0 23 23 23 23 21 21 21 21 24 24 22 0 0 0 0 0 0 0 0 0 0 0 0 21 21 21 21 0 0 0 0 23 23 
23 23 23 23 23 23 23 23 23 23 23 23 21 21 21 21 21 21 21 23 23 23 23 23 23 21 10 10 10 21 23 23 23 23 23 23 23 23 23 23 0 0 0 0 0 0 0 0 0 0 23 23 23 23 23 23 23 23 23 23 23 0 0 0 0 0 0 0 0 0 23 23 0 0 23 23 23 0 0 0 0 0 0 23 21 21 21 0 24 23 23 22 0 0 0 0 0 0 0 0 0 0 0 0 21 21 21 0 0 0 23 23 23 
23 23 23 23 23 23 23 23 23 23 23 23 23 21 21 21 21 23 23 23 23 23 23 23 23 21 10 10 10 23 23 23 23 23 23 23 0 0 0 0 0 0 0 0 0 0 0 23 23 23 23 24 24 24 23 23 23 23 23 23 0 0 0 0 0 0 0 0 0 0 23 23 0 0 0 23 23 23 0 0 0 0 23 23 21 21 0 0 23 0 0 0 0 0 0 0 0 0 0 0 0 0 0 0 0 21 0 0 0 0 23 23 23 
23 23 23 23 23 23 21 21 21 21 21 21 21 21 23 23 23 23 23 23 23 23 23 23 23 23 10 10 10 23 23 23 23 0 0 0 0 0 0 0 0 0 0 0 0 23 23 23 23 23 23 23 23 23 0 0 23 23 23 23 0 0 0 0 0 0 0 0 0 0 23 0 0 0 0 0 0 23 23 0 0 23 23 23 21 0 0 0 23 0 0 0 0 23 0 0 0 0 0 0 0 0 0 0 0 21 0 0 0 23 23 23 23 
23 23 23 23 23 23 23 23 23 23 23 21 21 23 21 23 23 23 23 23 23 23 23 23 23 21 10 10 10 23 0 0 0 0 0 0 0 0 0 0 0 0 23 23 23 23 23 0 0 0 0 0 0 0 0 0 0 23 23 23 23 0 0 0 0 0 0 0 0 0 0 0 0 0 0 0 0 0 0 0 0 23 23 23 21 0 0 0 0 0 0 0 0 23 23 0 0 0 0 0 0 0 0 0 0 21 0 0 0 23 23 23 23 
23 23 23 23 23 23 23 23 23 23 23 21 21 21 21 21 21 21 21 21 23 23 23 23 21 21 10 10 10 23 0 0 0 0 0 0 0 0 0 23 23 23 23 23 23 0 0 0 0 0 0 0 0 0 0 0 0 0 0 0 23 23 0 0 0 0 0 0 0 0 0 0 0 0 0 0 0 0 0 0 23 23 23 23 23 0 0 0 0 0 0 0 23 23 23 0 0 0 0 0 0 23 0 0 0 0 0 0 23 23 23 23 23 
23 23 23 23 23 23 23 23 24 23 23 21 24 24 21 21 21 21 21 23 23 23 23 23 23 21 10 10 10 21 10 10 10 23 23 23 23 23 23 23 23 23 23 0 0 0 0 0 0 0 0 23 23 23 23 0 0 0 0 0 0 23 23 23 23 0 0 0 0 0 0 0 0 0 0 0 0 0 0 0 23 23 23 23 23 23 0 0 0 0 0 23 23 23 23 23 0 0 0 0 0 23 23 0 0 0 0 0 23 23 23 23 23 
23 23 23 23 23 23 23 23 23 24 24 21 24 24 24 24 24 23 23 23 23 23 24 23 23 23 10 10 10 10 10 10 10 23 23 23 23 23 23 23 23 23 23 0 0 0 0 0 0 23 23 23 23 23 23 23 0 0 0 0 0 0 0 0 0 0 0 0 0 0 0 0 0 0 0 0 0 0 0 23 23 23 23 23 23 23 23 23 23 23 23 23 23 23 23 23 22 22 22 22 22 23 23 0 0 0 0 0 23 23 23 23 23 
23 23 23 23 23 23 23 23 23 23 24 24 24 24 23 23 24 24 23 23 23 23 24 24 23 24 21 10 10 10 10 10 23 23 23 23 24 24 24 24 23 23 23 0 0 0 0 0 23 23 23 24 24 24 24 23 0 0 0 0 0 0 0 0 0 0 0 23 23 0 0 0 0 0 0 0 0 0 23 23 23 23 23 23 23 23 23 23 23 23 23 23 23 23 23 23 21 21 21 21 23 23 23 23 0 0 0 0 23 23 23 23 23 
23 23 23 23 23 23 23 23 23 23 23 23 23 23 23 23 23 24 23 23 23 24 24 24 24 24 24 21 10 23 23 23 23 23 23 24 24 23 23 23 23 23 23 23 0 23 23 23 24 24 23 23 24 23 23 23 23 23 0 0 0 0 0 0 0 0 23 23 23 23 23 0 0 0 0 0 23 23 23 23 23 23 23 23 23 23 23 23 23 23 23 23 23 23 23 23 21 21 21 21 23 23 23 23 23 0 0 23 23 23 23 23 23 
23 23 23 23 23 23 23 23 23 23 23 23 23 23 23 23 23 24 24 24 23 23 23 24 24 23 23 23 23 23 23 23 23 23 23 24 23 23 23 23 23 23 23 23 23 23 23 23 23 24 24 24 24 24 24 23 23 23 23 23 23 23 23 23 23 23 23 23 23 24 23 23 23 23 23 23 23 23 23 23 23 23 23 23 23 23 23 23 23 23 23 23 23 23 23 23 23 21 23 23 23 23 23 23 23 23 23 23 23 23 23 23 23 
23 23 23 23 23 23 23 23 23 23 23 23 23 23 23 23 23 23 23 23 23 23 23 23 23 23 23 23 23 23 23 23 23 23 23 23 23 23 23 23 23 23 23 23 23 23 23 23 23 23 23 23 23 23 24 23 23 23 24 24 24 23 23 23 23 23 23 23 23 23 23 23 23 23 23 23 23 23 23 23 23 23 23 23 23 23 23 23 23 23 23 23 23 23 23 23 23 23 23 23 23 23 23 23 23 23 23 23 23 23 23 23 23 
