69
42
24 23 23 23 24 24 23 23 21 21 21 21 21 21 21 23 24 24 24 24 23 23 23 23 23 23 23 23 23 23 23 23 23 23 23 23 23 23 23 23 23 23 23 23 23 23 23 23 23 23 23 23 23 23 23 23 23 23 23 23 23 23 23 24 24 24 24 24 24 
23 24 24 23 23 24 23 23 23 23 23 23 23 23 24 24 23 23 23 23 0 0 0 0 0 0 0 0 0 0 0 0 0 0 0 0 0 0 0 0 0 0 0 0 0 0 0 9 9 9 0 0 0 0 0 0 0 0 0 0 0 0 0 0 0 0 0 0 24 
24 24 23 24 23 0 0 0 0 0 0 0 0 0 23 23 23 0 0 23 0 0 0 0 0 0 0 0 0 0 0 0 0 0 0 0 0 23 24 24 24 23 23 23 23 23 23 10 10 10 23 23 23 23 23 23 23 0 0 0 0 0 0 0 0 0 0 0 24 
24 23 23 0 0 0 0 0 0 0 0 0 0 0 0 0 23 23 0 0 0 0 0 0 0 0 0 0 0 0 0 0 0 0 23 23 23 23 24 23 24 23 23 0 0 0 0 10 10 10 0 0 0 0 0 0 23 23 0 0 0 0 0 0 0 0 0 0 23 
24 23 0 0 0 0 0 0 0 0 0 0 0 0 0 0 0 23 23 0 0 0 0 0 0 0 0 0 0 23 23 23 23 23 23 23 23 23 23 23 23 23 23 0 0 0 0 10 10 10 0 0 0 0 0 0 0 0 23 23 0 0 0 0 0 0 23 23 23 
24 0 0 0 0 0 0 0 0 0 0 0 0 0 0 0 0 0 23 0 0 0 0 0 0 0 0 0 0 0 0 0 0 23 23 0 0 0 0 23 23 23 24 23 0 0 0 10 10 10 0 0 0 0 0 0 0 0 0 0 23 23 23 23 23 23 0 21 23 
24 0 0 0 0 0 0 0 0 0 0 0 0 0 0 0 0 0 23 23 23 0 0 0 0 0 0 0 0 0 23 23 23 23 0 0 0 0 23 23 0 23 23 23 0 0 0 10 10 10 0 0 0 0 0 0 0 0 0 0 0 0 0 0 0 0 0 6 21 
21 0 0 0 0 0 0 0 0 0 0 24 24 0 0 0 0 0 0 0 23 24 24 24 23 0 0 0 23 23 23 0 0 0 0 0 0 23 23 0 0 23 23 0 0 0 0 10 10 10 0 23 23 23 23 0 0 0 0 0 0 0 0 0 0 0 0 6 21 
21 0 0 0 23 23 0 0 23 23 24 24 23 23 0 0 0 0 0 0 0 0 0 0 23 23 0 0 0 0 0 0 0 0 0 0 0 24 0 0 0 0 0 0 0 0 0 10 10 10 0 23 23 23 23 23 0 0 0 0 0 0 0 0 0 0 21 21 21 
21 0 21 21 21 21 21 0 0 23 0 0 23 23 23 0 0 0 0 0 0 0 0 0 0 23 23 23 23 0 0 23 24 23 23 23 24 24 0 0 0 0 0 0 0 0 0 10 10 10 0 0 0 0 23 23 23 0 0 0 0 0 0 0 0 21 21 21 21 
21 0 0 0 21 21 21 21 0 0 0 0 0 23 23 23 0 0 0 0 0 0 0 0 0 0 0 0 23 23 23 0 0 0 0 0 0 0 0 0 0 0 0 0 0 0 0 10 10 10 0 0 0 0 0 23 23 23 23 23 0 0 0 0 0 5 5 5 21 
21 23 0 0 23 21 21 21 23 21 23 0 23 24 23 23 23 0 0 0 0 0 0 0 0 0 0 0 0 0 0 0 0 0 0 21 0 0 0 0 0 0 0 0 0 0 0 10 10 10 0 0 0 0 0 0 0 0 0 0 0 0 0 0 21 21 5 5 21 
21 23 23 23 23 23 21 21 21 21 23 23 23 0 0 0 0 0 0 0 0 0 0 0 0 0 0 0 0 0 0 0 0 0 0 21 0 0 0 0 0 0 0 0 0 0 0 10 10 10 0 0 0 0 0 0 0 0 0 0 0 0 0 21 5 5 5 21 21 
21 23 23 23 0 0 23 23 24 23 23 24 23 23 0 24 24 24 0 0 0 0 0 0 0 0 0 0 0 0 0 0 0 0 0 21 22 22 0 0 0 0 0 0 0 0 0 10 10 10 0 0 0 0 0 0 0 0 0 0 0 23 21 21 5 5 21 21 21 
21 0 0 0 0 0 0 23 23 23 23 24 23 0 0 0 0 24 24 24 24 0 0 0 0 0 0 0 0 0 0 0 0 0 0 0 0 21 22 22 22 0 0 0 0 21 0 10 10 10 0 0 0 0 0 0 0 23 23 23 23 23 21 21 21 5 5 5 21 
21 0 0 0 0 0 0 0 0 0 0 0 0 0 0 0 0 0 0 0 0 0 0 0 0 23 23 0 0 0 0 0 0 0 0 0 0 0 0 21 21 22 22 22 22 21 0 10 10 10 0 0 0 0 0 0 23 23 21 21 21 21 21 21 21 21 5 5 21 
21 0 0 0 0 0 0 0 0 0 0 0 0 0 0 0 0 0 0 0 0 0 0 0 0 0 23 23 24 0 0 0 0 0 0 0 0 0 0 0 21 21 21 21 21 0 0 10 10 10 0 0 0 0 0 0 24 21 21 5 5 5 5 5 5 5 5 21 21 
21 0 0 0 0 0 0 0 0 0 0 0 0 0 0 0 0 0 0 0 0 23 0 0 0 0 0 0 23 23 0 0 0 0 0 0 0 0 0 21 21 21 21 21 0 0 0 10 10 10 0 0 0 0 0 0 24 21 21 5 5 21 21 21 21 21 21 21 21 
21 0 0 0 0 0 0 0 0 0 0 0 0 0 0 0 0 0 23 23 24 23 23 23 0 0 0 0 0 23 23 0 0 0 0 0 0 0 0 0 21 21 21 0 0 0 0 10 10 10 23 0 0 0 0 0 24 23 21 21 5 5 5 5 5 21 21 21 21 
21 0 0 0 0 0 0 0 0 0 0 0 0 0 23 23 24 23 23 0 23 0 0 23 23 0 0 0 0 0 23 23 0 0 0 0 0 0 0 0 0 21 21 0 0 0 0 10 10 10 23 23 0 0 0 0 0 23 23 21 21 21 21 5 5 5 21 21 21 
21 21 0 0 0 0 0 0 0 0 0 0 23 23 24 24 23 23 23 0 0 0 0 0 23 23 0 23 0 0 0 23 23 0 0 0 0 0 0 0 0 21 21 0 0 0 0 10 10 10 24 23 0 0 0 0 0 0 23 21 21 21 21 21 5 5 5 21 21 
21 21 21 21 22 0 0 0 0 0 23 23 23 0 0 0 0 0 0 0 0 0 0 0 0 23 23 23 0 0 0 0 0 0 0 0 0 0 0 0 0 21 21 0 0 0 0 10 10 10 23 23 0 0 0 0 0 0 0 23 23 23 21 21 21 5 5 21 21 
21 21 21 21 21 22 22 0 0 0 0 0 0 0 23 23 23 23 23 23 0 0 23 23 23 23 24 23 23 23 23 0 0 0 0 0 23 23 0 0 0 0 21 0 0 0 0 10 10 10 23 24 23 0 0 0 0 0 0 0 0 23 23 21 21 21 5 21 21 
21 21 21 21 21 5 21 22 0 0 0 0 0 23 23 0 0 0 0 0 23 0 23 0 0 23 24 24 23 23 23 0 0 0 0 23 23 0 0 0 0 0 21 0 0 0 0 10 10 10 23 24 24 23 24 0 0 0 0 0 0 0 23 21 21 0 0 21 21 
21 0 0 21 21 5 21 21 22 0 0 0 23 23 0 0 0 0 0 0 0 0 0 0 0 0 23 23 23 0 23 23 23 23 23 0 23 0 0 0 0 0 21 0 0 0 0 10 10 10 0 23 23 23 23 24 0 0 0 0 0 23 23 21 0 0 21 21 21 
21 0 0 0 0 0 0 21 21 22 0 0 0 0 0 0 0 0 0 0 0 0 0 0 0 0 23 23 0 0 0 0 0 0 0 0 0 0 0 0 0 0 0 0 0 0 0 10 10 10 0 0 23 24 23 23 23 0 0 0 0 23 24 24 0 21 21 0 21 
21 0 0 0 0 0 0 0 21 21 0 0 0 0 0 22 22 22 22 0 0 0 0 0 0 0 23 0 0 0 0 0 0 0 0 0 0 0 0 0 0 0 0 0 0 0 0 10 10 10 0 0 0 24 24 0 0 0 0 0 0 0 23 24 0 0 0 0 21 
21 23 0 0 0 0 0 0 21 21 0 0 0 0 22 5 0 0 0 0 0 0 0 23 0 0 23 0 0 0 0 0 0 0 0 0 0 0 0 0 0 0 0 0 0 0 0 10 10 10 0 0 0 24 0 0 0 0 0 0 0 23 21 23 23 0 0 0 21 
21 23 0 0 0 0 0 0 21 21 22 22 22 22 5 0 0 0 0 0 0 0 0 0 0 0 24 23 0 0 0 0 0 0 0 0 0 0 0 0 0 0 0 0 0 0 0 10 10 10 0 0 0 0 0 0 0 0 0 0 23 23 21 0 23 23 0 0 21 
21 0 23 0 0 0 0 0 21 21 21 21 5 0 0 0 0 0 0 0 0 0 0 0 0 0 0 23 0 0 0 0 0 0 0 0 0 0 0 0 0 0 0 0 0 0 0 10 10 10 0 0 0 0 0 0 0 23 23 23 23 23 21 0 0 0 0 0 21 
21 0 0 23 23 23 0 0 21 21 21 21 5 0 0 0 0 0 0 0 0 23 0 0 0 0 0 0 0 0 0 0 0 0 0 0 0 0 0 0 0 0 0 0 0 0 0 10 10 10 0 0 0 0 0 0 23 24 24 23 23 23 21 0 0 0 0 23 21 
21 0 0 0 0 0 0 0 0 21 21 21 5 7 0 0 0 0 0 0 0 0 0 0 0 0 0 0 0 0 0 0 0 0 0 0 0 0 0 0 0 0 0 0 0 0 0 10 10 10 0 0 0 0 0 23 23 23 23 23 24 23 24 0 0 24 24 23 21 
21 0 0 0 0 0 0 0 24 23 21 21 5 7 0 0 0 0 0 0 0 0 0 0 0 0 0 0 0 0 0 0 0 0 0 0 0 0 0 0 0 23 23 0 0 0 9 10 10 10 23 23 23 23 23 23 23 24 24 24 24 23 24 0 23 23 0 0 21 
21 0 0 0 0 0 0 24 23 0 0 21 5 5 22 22 22 22 33 0 0 0 0 0 0 0 0 0 0 0 0 0 0 0 0 0 0 0 23 23 23 23 23 0 0 9 10 10 10 10 24 23 24 23 23 23 23 23 23 23 23 23 24 0 0 0 0 0 21 
21 0 0 0 23 23 24 24 0 0 0 5 5 5 23 23 23 24 23 23 23 23 9 9 9 9 9 9 9 9 9 9 9 9 9 9 23 23 23 24 24 24 24 9 9 10 10 10 10 23 24 23 23 21 21 21 21 23 24 23 0 23 23 23 23 0 0 0 24 
21 0 0 0 0 0 0 0 0 0 0 0 0 5 5 5 23 24 24 24 10 23 23 23 10 10 10 10 10 10 10 23 23 24 24 24 23 10 10 10 10 10 10 10 10 10 10 10 23 23 24 24 24 21 21 21 21 23 23 0 0 0 0 0 23 23 0 0 24 
21 0 0 0 0 0 0 0 0 0 0 0 0 0 0 0 0 0 23 24 10 10 10 24 24 23 10 10 10 10 23 10 10 10 10 10 10 10 10 10 10 10 10 10 10 10 10 10 10 10 10 23 23 23 23 21 21 21 21 0 0 0 0 0 0 0 0 0 24 
21 21 0 0 0 0 0 0 0 0 0 0 24 23 23 23 10 10 10 10 10 10 10 10 10 10 10 10 10 10 10 10 10 10 10 10 24 10 10 10 10 10 10 10 10 10 10 10 10 10 10 10 10 23 24 0 0 23 0 0 0 0 0 0 0 0 0 23 24 
21 21 9 9 9 9 9 9 9 24 24 24 24 23 23 23 23 23 10 10 10 10 10 10 10 10 10 10 10 10 10 10 10 10 10 24 10 10 10 10 10 10 10 10 10 10 10 10 10 10 10 10 10 10 24 24 0 0 0 23 0 0 0 0 0 0 23 23 24 
21 21 21 21 10 10 10 10 10 24 24 10 10 10 10 10 10 10 10 10 10 10 10 10 10 10 10 10 10 10 10 10 10 24 24 10 23 10 23 10 10 10 10 10 10 10 10 10 10 10 10 10 10 10 23 24 23 0 0 0 0 0 0 0 0 0 23 24 24 
21 21 21 21 21 21 21 21 21 23 24 10 10 10 10 10 23 24 23 23 23 24 10 10 10 10 10 10 10 10 10 10 10 10 10 10 10 10 10 10 10 10 10 10 24 24 24 23 10 10 10 10 10 10 23 23 23 23 0 0 0 0 0 0 0 24 24 24 24 
21 21 21 21 21 21 21 21 33 23 24 24 24 23 23 23 23 23 24 23 23 23 23 23 23 23 24 24 24 23 23 23 23 23 23 23 23 23 23 23 23 23 23 23 23 23 23 23 23 23 23 23 23 23 23 24 24 24 24 24 24 24 24 24 23 23 23 23 24 
