28
12
24 23 23 23 23 21 21 21 21 21 21 21 21 21 21 23 23 21 21 21 23 21 23 21 23 24 24 24 
23 0 0 0 23 23 0 0 0 0 0 0 0 0 21 21 23 23 21 23 23 23 21 0 0 23 23 24 
23 0 0 0 23 0 0 0 0 0 0 0 0 0 0 0 0 23 23 23 23 0 0 0 0 23 24 24 
23 0 0 0 0 0 0 0 0 0 0 0 0 0 0 0 0 0 23 23 0 0 0 0 0 0 23 23 
23 0 0 0 0 0 0 0 0 0 0 0 0 0 0 0 0 0 23 0 0 0 0 0 0 0 0 21 
23 0 0 0 0 0 0 0 0 0 0 0 0 0 0 0 0 0 0 0 0 0 0 0 0 0 0 21 
23 0 0 0 0 0 0 0 0 0 0 0 0 0 0 0 0 0 0 0 0 0 0 0 0 0 0 21 
23 0 0 0 0 0 0 0 0 0 0 0 0 0 0 0 0 0 0 0 0 0 0 0 0 0 0 21 
23 0 0 0 0 0 0 0 0 0 0 0 0 0 0 0 0 0 0 0 0 0 0 0 0 0 0 21 
7 0 0 0 0 0 0 0 0 0 0 0 0 0 0 0 0 0 0 0 0 0 0 0 0 0 0 6 
7 0 0 0 0 0 3 22 22 22 22 22 22 22 4 0 0 0 0 0 0 0 0 0 0 0 0 6 
21 22 22 22 22 22 22 26 32 32 32 32 32 25 22 22 22 22 22 22 22 22 22 22 22 22 22 21 
