35
30
23 23 23 23 23 24 24 23 24 23 23 23 23 23 23 23 23 23 21 21 21 21 21 21 21 21 21 21 21 21 21 21 21 21 21 
23 24 23 23 23 23 23 23 23 0 0 0 0 0 0 0 0 0 0 0 0 0 0 0 0 0 0 0 21 21 21 21 21 21 21 
23 23 23 0 0 0 0 0 0 0 0 0 0 0 0 0 0 0 0 0 0 0 0 0 0 0 0 0 0 21 21 21 21 0 21 
21 23 24 0 0 0 0 0 0 0 0 0 0 0 0 0 0 0 0 0 0 0 0 0 0 0 0 0 0 0 21 21 21 0 21 
21 23 0 0 0 0 0 0 0 0 0 0 0 0 0 0 0 0 0 0 0 0 0 0 0 0 0 0 0 0 6 21 21 0 21 
21 23 0 0 0 0 0 0 0 0 0 0 0 0 0 0 0 0 0 22 22 22 22 22 22 0 0 0 0 0 6 21 0 0 21 
21 24 23 23 0 0 0 0 0 0 0 0 0 0 0 0 0 0 0 0 0 0 0 0 21 22 22 22 22 22 21 0 0 0 21 
21 0 0 23 23 23 23 23 0 0 0 0 0 0 23 0 0 0 0 0 0 0 0 0 0 0 0 0 0 0 0 0 0 0 21 
21 0 0 0 0 0 0 0 0 0 0 0 0 0 23 23 23 0 0 0 0 0 0 0 0 0 0 0 0 0 0 0 0 23 23 
21 0 0 0 0 0 0 0 0 21 21 0 0 23 23 23 23 23 23 0 0 0 0 23 0 0 0 0 0 0 23 23 23 0 23 
21 0 0 0 0 0 21 21 21 21 0 0 0 23 23 23 0 0 23 23 0 0 0 23 0 0 0 0 23 23 23 0 0 0 23 
21 0 0 0 0 21 21 0 0 0 0 0 23 23 0 0 0 0 0 23 23 23 23 23 0 0 0 23 23 0 0 0 0 0 23 
21 0 0 0 0 0 0 0 0 0 0 0 0 0 0 0 0 0 0 0 0 23 23 23 0 0 0 0 0 0 0 0 0 0 23 
21 21 21 0 0 0 0 0 0 0 0 0 0 0 0 0 0 0 0 0 0 0 0 23 23 0 23 23 23 23 0 0 0 0 23 
21 21 21 21 0 0 0 0 0 0 23 0 0 0 0 0 23 23 0 0 0 0 0 0 23 0 0 0 0 0 23 23 23 23 23 
21 21 21 5 5 21 21 21 0 0 23 23 23 0 0 23 0 23 23 0 23 23 0 0 0 0 0 0 0 0 0 0 0 0 23 
23 5 5 5 21 0 0 0 0 0 0 0 23 0 0 0 0 0 0 23 23 0 0 0 0 0 0 0 0 0 0 0 0 0 23 
23 9 21 21 7 0 0 0 0 0 0 0 23 23 0 0 0 0 0 0 0 0 0 0 23 0 0 0 0 0 0 0 0 0 21 
23 10 21 21 7 0 0 0 0 0 0 0 0 23 23 0 0 23 23 23 23 23 23 23 23 0 23 0 0 0 0 0 0 0 21 
23 10 0 21 21 22 22 0 0 0 0 0 0 0 23 23 23 23 23 23 23 23 23 0 0 0 0 0 0 22 22 0 0 0 21 
23 10 0 0 21 0 0 0 0 0 0 0 0 0 0 0 0 0 23 23 23 0 0 0 0 0 0 0 22 21 21 22 22 0 21 
23 10 0 0 21 21 0 0 0 0 0 0 0 0 0 0 0 0 0 23 0 0 0 0 0 0 0 22 21 0 0 0 0 21 21 
23 10 0 0 0 0 22 22 22 0 0 0 0 0 0 0 0 0 0 0 0 0 0 0 0 0 22 21 0 0 0 0 0 0 21 
23 10 9 9 0 0 0 0 21 22 22 22 0 0 0 0 0 0 22 22 22 22 22 22 22 22 21 0 0 0 0 0 0 0 21 
23 10 10 10 9 9 9 0 0 0 0 21 21 0 0 0 0 0 0 0 0 0 0 0 0 0 0 0 0 0 0 0 0 21 21 
23 23 23 10 10 10 10 9 0 0 0 0 21 21 0 0 0 0 0 0 0 0 0 0 0 0 0 0 0 0 0 0 0 21 21 
23 23 23 23 23 23 10 10 9 9 0 0 0 0 0 0 0 0 0 0 0 0 0 0 0 0 0 0 0 0 22 22 22 21 21 
24 23 23 23 24 23 23 10 10 10 9 9 9 9 9 9 9 9 9 9 9 9 9 9 9 9 9 9 22 22 21 21 21 21 21 
23 24 24 23 23 23 23 23 23 10 10 10 10 10 10 10 10 10 10 10 10 10 10 10 10 10 10 10 21 21 21 21 21 23 23 
23 23 23 23 24 24 23 24 23 23 23 23 23 23 23 23 23 23 23 23 23 23 23 23 23 23 23 21 21 21 21 21 23 21 23 
