68
27
21 21 21 21 21 21 21 21 21 21 21 21 21 23 23 23 23 23 21 21 21 21 21 23 23 23 21 21 21 21 23 23 23 23 23 23 23 23 23 23 23 21 21 21 21 23 23 23 23 23 23 21 21 21 21 21 21 21 21 21 21 21 21 21 21 21 21 21 
23 21 21 21 21 21 21 0 0 0 0 21 21 21 23 23 21 21 21 21 21 0 21 21 23 21 21 0 21 21 21 21 23 23 23 23 23 23 21 21 21 21 21 21 21 21 21 23 23 21 21 21 21 21 21 21 21 21 21 21 21 0 0 21 21 0 21 21 
21 21 21 23 21 21 0 0 0 0 0 0 0 21 21 23 21 0 0 0 0 0 0 21 23 21 0 0 0 21 21 21 21 21 21 21 21 21 21 21 0 0 0 0 0 0 21 21 23 21 0 0 0 0 21 21 21 21 21 21 0 0 0 21 21 0 0 21 
21 21 21 21 21 0 0 0 0 0 0 0 0 0 21 21 0 0 0 0 0 0 0 21 21 21 0 0 0 0 0 0 21 21 21 21 21 21 0 0 0 0 0 0 0 0 0 21 21 0 0 0 0 0 0 0 21 21 21 21 0 0 0 0 21 0 0 21 
21 21 21 21 0 0 0 0 0 0 0 0 0 0 21 21 0 0 0 0 0 0 0 21 21 0 0 0 0 0 0 0 0 0 0 0 0 0 0 0 0 0 0 0 0 0 0 21 21 0 0 0 0 0 0 0 0 21 21 21 0 0 0 0 21 0 0 21 
21 21 21 0 0 0 0 0 0 0 0 0 0 0 0 21 0 0 0 0 0 0 0 21 21 0 0 0 0 0 0 0 0 0 0 0 0 0 0 0 0 0 0 0 0 0 0 0 21 0 0 0 0 0 0 0 0 0 21 21 0 0 0 0 21 0 0 21 
21 23 21 0 0 0 0 0 0 0 0 0 0 0 0 21 0 0 0 0 0 0 0 0 21 0 0 0 0 0 0 0 0 0 0 0 0 0 0 0 0 0 0 0 0 0 0 0 0 0 0 0 0 0 0 0 0 0 21 21 0 0 0 0 0 0 0 21 
21 21 21 0 0 0 0 0 0 0 0 0 0 0 0 0 0 0 0 0 0 0 0 0 21 0 0 0 0 0 0 0 0 0 0 0 0 0 0 0 0 0 0 0 0 0 0 0 0 0 0 0 0 0 0 0 0 0 0 0 0 0 0 0 0 0 0 21 
21 21 0 0 0 0 0 0 0 0 0 0 0 0 0 0 0 0 0 0 0 0 0 0 0 0 0 0 0 0 0 0 0 0 0 0 0 0 0 0 0 0 0 0 0 0 0 0 0 0 0 0 0 0 0 0 0 0 0 0 0 0 0 0 0 0 0 21 
21 21 0 0 0 0 0 0 22 22 4 0 0 0 0 0 0 0 0 0 0 0 0 0 0 0 0 0 0 0 0 0 0 0 0 0 0 0 0 0 0 0 0 0 0 0 22 0 0 0 0 0 0 0 0 0 0 0 0 0 0 0 0 0 0 0 0 21 
21 21 0 0 0 0 0 22 21 0 0 0 0 0 0 0 0 0 0 0 0 0 0 0 0 0 0 0 0 0 0 0 0 0 0 0 0 0 0 0 0 0 0 0 0 0 21 0 0 0 0 0 0 0 0 0 0 0 0 0 0 0 0 0 0 0 0 21 
21 21 0 0 0 0 22 21 21 0 0 0 0 0 0 0 0 0 0 0 0 0 0 0 0 0 0 0 0 0 0 0 0 0 0 0 0 0 0 0 0 0 0 0 0 0 21 0 0 0 0 0 0 0 0 0 0 0 0 0 0 0 0 0 0 0 0 6 
21 21 0 0 0 22 21 21 21 0 0 0 0 0 0 0 0 0 0 0 0 0 0 0 0 0 0 0 0 0 0 0 0 0 0 0 0 0 0 0 0 0 0 0 0 0 21 0 0 0 0 0 0 0 0 0 0 0 0 0 0 0 0 0 0 0 0 6 
21 21 0 0 22 21 21 21 21 22 22 22 22 22 22 22 22 22 22 22 22 4 0 0 0 0 3 22 22 22 22 22 22 22 22 22 22 22 22 22 22 9 9 9 9 9 25 22 22 22 9 9 9 9 9 9 22 22 22 22 22 22 22 22 22 22 22 22 
21 21 21 0 0 0 0 21 21 21 21 21 21 23 21 21 21 21 23 21 21 0 0 0 0 0 0 21 21 21 21 21 21 21 21 21 21 21 21 21 21 10 10 10 10 10 21 21 21 21 10 10 10 10 10 10 21 21 21 21 23 21 21 21 21 21 21 21 
21 21 21 21 0 0 0 0 0 21 21 21 21 21 21 21 21 21 21 21 21 0 0 0 0 0 0 0 21 21 23 23 23 21 21 21 21 21 21 21 21 10 10 10 10 10 21 21 21 10 10 10 10 10 10 21 21 21 21 21 21 21 21 21 21 21 21 21 
21 21 21 21 21 0 0 0 0 0 0 21 21 21 21 21 21 23 21 21 21 0 0 0 0 0 0 0 21 21 21 23 23 21 23 23 21 21 23 21 21 21 10 10 10 10 21 21 10 10 10 10 10 10 10 21 23 21 21 21 21 21 23 21 21 21 21 21 
21 23 21 21 21 0 0 0 0 0 0 0 0 0 0 21 21 21 21 21 21 0 0 0 0 0 0 0 0 21 21 21 23 23 23 21 21 21 21 21 21 21 10 10 10 10 21 21 10 10 10 10 10 10 21 21 21 21 21 23 21 21 21 21 21 21 23 21 
21 23 21 21 21 21 0 0 0 0 0 0 0 0 0 0 0 0 0 0 21 0 0 0 0 0 0 0 0 21 21 21 23 23 21 21 21 21 23 21 21 21 10 10 10 10 10 10 10 10 10 10 10 21 21 21 23 21 21 21 23 21 21 21 21 21 21 21 
21 23 21 23 21 21 21 21 0 0 0 0 0 0 0 0 0 0 0 0 0 0 0 0 0 0 0 0 0 0 21 23 23 21 21 21 21 21 21 23 21 21 21 10 10 10 10 10 10 10 10 21 21 21 21 23 23 21 21 21 21 21 21 21 21 23 21 21 
21 23 21 23 23 21 21 23 23 21 21 21 21 21 21 21 21 21 21 21 23 23 23 21 21 21 21 21 21 21 21 23 21 21 21 23 21 21 21 21 21 21 21 10 10 10 10 10 10 21 21 21 21 21 21 21 23 21 21 21 23 21 21 21 21 23 21 21 
21 21 21 21 23 21 23 21 21 21 23 23 21 21 21 23 23 23 21 21 21 21 21 21 23 23 23 23 21 21 21 23 21 21 21 21 21 21 21 21 23 23 21 21 10 10 10 10 21 21 21 21 21 21 21 21 21 21 21 21 21 21 23 21 21 21 21 21 
21 21 21 21 21 21 23 21 21 21 23 23 21 21 21 21 23 21 21 23 21 21 21 21 21 21 21 23 21 21 21 23 21 21 21 21 23 21 21 21 21 21 21 21 10 10 10 10 21 21 21 23 21 21 21 21 21 21 21 23 21 21 21 21 21 21 21 21 
21 21 21 21 21 21 21 21 21 21 21 21 21 21 21 21 21 21 21 23 23 23 21 21 23 21 21 21 21 23 21 21 21 21 21 21 21 21 21 21 21 21 23 21 21 21 21 21 21 21 21 23 21 21 21 23 21 21 21 21 21 21 21 21 21 21 21 21 
21 21 21 23 21 21 21 21 21 23 23 21 21 21 21 21 21 21 21 21 21 21 21 21 23 21 21 21 21 21 23 21 21 21 21 21 21 21 21 21 21 21 21 21 21 21 21 21 21 21 23 23 21 21 21 23 21 21 21 21 21 21 21 23 23 21 21 21 
23 21 21 21 21 21 21 21 21 21 23 23 21 21 21 21 23 21 21 21 21 21 21 21 21 21 21 21 21 21 21 21 21 21 21 21 21 21 21 23 21 21 21 21 21 21 23 21 21 21 21 21 21 21 21 21 21 21 23 21 21 21 21 21 21 21 21 21 
21 23 21 21 21 21 21 21 21 21 21 23 21 23 23 23 23 23 21 21 21 21 21 21 21 21 21 21 21 21 21 21 21 21 21 21 21 21 21 21 21 21 21 21 21 21 21 21 21 21 21 21 21 21 21 21 21 21 21 21 21 21 21 21 21 21 21 21 
