51
27
21 21 21 21 21 21 21 21 21 21 21 21 21 21 21 21 21 21 21 21 21 21 21 21 21 21 21 21 21 21 21 21 21 21 21 21 21 21 21 21 21 21 21 21 21 21 23 24 23 23 23 
21 21 21 21 21 21 0 0 0 0 0 0 0 0 0 0 0 21 21 21 21 21 21 21 21 21 21 21 21 21 21 0 0 0 0 0 0 0 0 0 0 0 21 21 21 21 21 23 21 23 23 
23 23 21 21 7 0 0 0 0 0 0 0 0 0 0 0 0 0 0 0 0 0 0 21 21 21 21 21 21 21 21 21 21 21 21 0 0 0 0 0 0 0 0 0 21 21 21 21 21 21 24 
23 21 21 21 7 0 0 0 0 0 0 0 0 0 0 0 0 0 0 0 0 0 0 0 0 0 0 0 0 0 21 21 21 21 21 21 21 0 0 0 0 0 0 0 0 0 0 0 21 21 24 
24 23 21 21 21 22 22 22 22 22 22 22 22 22 0 0 0 0 0 0 0 0 0 0 0 0 0 0 0 0 0 0 0 21 21 21 21 21 0 0 0 0 0 0 0 0 0 0 21 21 21 
24 23 21 21 21 21 21 21 21 21 21 21 21 21 22 22 22 22 22 22 22 0 22 22 22 0 0 0 0 0 0 0 0 0 0 21 21 21 0 0 0 0 0 0 0 0 0 0 0 21 21 
23 23 24 23 23 23 21 21 21 23 23 23 21 21 21 5 5 5 5 5 5 5 21 21 21 21 0 0 0 0 0 0 0 0 0 0 21 21 21 21 0 0 0 21 21 0 0 0 0 0 21 
21 21 23 23 23 24 0 0 21 0 0 0 0 0 0 5 21 21 21 21 21 21 21 21 21 21 22 22 22 22 0 0 0 0 0 0 0 21 21 21 21 21 21 21 21 21 0 0 0 21 21 
21 0 0 0 0 0 0 0 0 0 0 0 0 0 0 21 21 0 21 21 0 0 21 21 21 21 21 21 21 21 22 22 0 0 0 0 0 0 0 21 21 21 21 21 21 0 0 0 21 21 23 
21 0 0 0 21 21 21 0 0 0 0 21 21 21 21 21 0 0 0 0 0 0 0 21 23 21 21 21 21 21 21 21 22 22 22 0 0 0 0 0 0 0 0 21 21 21 0 0 0 0 23 
21 0 0 21 21 21 21 21 0 0 0 0 0 0 0 0 0 0 0 0 0 21 21 21 23 21 21 21 21 21 21 21 21 21 21 22 0 0 0 0 0 0 0 0 0 21 21 0 0 23 23 
21 0 0 0 21 0 0 0 0 0 0 21 0 0 0 0 0 0 0 21 21 21 21 21 24 21 0 21 0 21 0 21 21 21 21 21 22 22 22 22 22 0 0 0 0 0 0 0 23 23 23 
21 21 0 0 0 0 0 0 0 0 21 21 21 21 21 0 0 0 0 0 0 0 24 21 23 0 0 21 0 0 0 0 0 21 21 21 21 21 21 0 0 0 0 0 0 0 21 21 21 23 23 
23 23 21 0 0 0 21 21 21 21 23 23 23 23 21 21 21 0 0 0 0 0 21 24 23 0 0 21 0 0 0 0 0 0 21 21 0 0 0 0 0 0 0 21 0 21 21 21 21 21 23 
24 23 21 21 21 21 23 24 23 23 23 23 21 21 21 21 21 21 21 21 5 5 21 23 23 0 0 0 0 0 0 0 0 0 0 0 0 0 0 0 21 21 0 21 21 21 23 21 21 21 23 
23 23 23 23 24 24 24 23 0 0 0 0 0 0 0 5 5 5 5 5 5 21 23 23 0 0 0 0 0 21 21 21 0 0 0 0 0 0 0 21 21 21 0 0 21 21 23 23 23 23 21 
23 0 23 23 24 0 0 0 0 23 23 0 0 0 0 0 21 21 21 21 21 21 0 0 0 0 0 0 21 21 21 21 21 0 0 0 0 21 21 21 21 0 0 0 0 21 21 23 23 23 21 
24 0 0 0 0 0 0 0 23 23 23 24 24 24 23 0 0 0 0 0 0 0 0 0 0 21 21 21 21 21 21 21 21 21 21 0 0 0 0 0 0 0 0 0 0 6 21 21 23 23 21 
24 0 0 0 0 0 0 23 23 23 23 23 23 0 0 0 0 0 0 0 0 0 0 0 21 0 0 0 0 0 21 0 0 0 0 0 0 0 0 0 0 0 0 0 0 6 21 21 23 23 21 
24 23 0 0 0 0 0 0 0 23 23 23 0 0 0 0 0 0 0 0 0 0 0 0 0 0 0 0 0 0 0 0 0 0 0 0 0 0 0 0 0 0 22 22 22 21 21 21 23 23 21 
24 23 23 23 23 0 0 0 0 0 23 0 0 0 0 0 0 0 0 23 23 23 23 9 9 9 9 9 9 9 9 9 9 9 9 9 21 21 21 0 0 0 0 0 0 0 0 0 0 23 23 
21 23 23 24 23 23 0 0 0 0 0 0 0 0 0 0 0 23 23 23 10 23 10 10 10 10 10 10 10 10 10 10 10 10 10 10 10 21 21 22 22 0 0 0 0 0 0 0 0 23 23 
23 24 23 23 23 23 0 0 0 0 0 0 0 0 0 0 23 21 21 10 10 10 10 10 10 10 10 10 10 10 10 10 10 10 10 10 10 10 10 21 21 22 22 22 22 0 0 0 0 0 23 
24 23 21 24 23 23 23 23 0 0 0 0 0 0 0 23 21 10 10 10 10 10 10 10 10 10 10 10 10 10 10 10 10 10 10 21 21 10 10 10 21 21 21 21 21 22 22 0 0 0 23 
23 23 21 23 23 23 23 23 23 24 24 24 24 23 23 21 21 10 21 21 10 21 10 10 10 10 21 21 10 21 21 21 21 10 21 21 21 21 21 10 10 10 21 21 21 21 21 21 0 21 21 
23 23 23 23 23 23 23 23 23 23 23 23 23 21 21 21 21 21 21 21 21 21 21 10 10 21 21 10 10 10 10 10 10 10 21 21 21 21 21 21 21 21 21 21 21 21 21 21 21 21 21 
23 23 23 23 23 23 23 23 23 23 23 23 23 21 21 21 21 21 21 21 21 21 21 21 21 21 21 21 21 21 21 21 21 21 21 21 21 21 21 21 21 21 21 21 21 21 21 21 21 21 21 
