29
18
21 21 21 21 21 21 21 21 21 21 21 21 21 21 21 21 21 21 21 21 21 21 21 21 21 21 21 21 21 
21 0 0 0 0 0 0 21 21 21 21 21 0 0 0 5 5 5 5 5 21 21 21 21 21 21 21 21 21 
21 0 0 0 0 0 0 0 0 21 21 0 0 0 0 21 21 5 5 5 5 5 21 21 21 21 21 21 21 
21 0 0 0 0 21 0 0 0 21 0 0 0 0 0 21 21 21 21 5 5 5 5 0 0 0 0 21 21 
21 5 0 0 0 21 0 0 21 0 0 0 0 0 21 21 21 21 21 21 21 21 21 21 0 0 0 0 21 
21 7 0 0 21 21 0 0 0 0 0 0 0 0 6 21 21 21 21 21 21 0 0 0 21 0 0 0 21 
21 7 0 21 21 21 5 0 0 0 0 0 0 0 6 21 21 21 21 21 0 0 0 0 0 0 0 0 21 
21 21 22 21 21 5 5 22 22 22 22 22 22 22 21 21 21 0 0 21 0 0 0 0 0 0 0 21 21 
21 21 5 5 5 5 21 21 21 21 21 21 21 21 21 21 21 0 0 0 0 0 0 21 21 21 0 21 21 
21 21 5 21 21 21 21 21 21 0 0 0 0 0 0 21 21 0 0 0 0 21 21 21 21 0 0 21 21 
21 21 5 21 21 21 21 0 0 0 0 0 0 0 0 0 0 0 0 0 0 0 21 21 21 0 0 0 21 
21 21 5 21 0 0 0 0 0 0 0 0 21 0 0 0 0 0 21 21 0 0 0 0 21 0 0 0 21 
21 0 0 0 0 0 0 0 0 0 21 21 21 21 21 21 21 21 21 0 0 21 0 0 0 0 0 0 21 
21 0 0 0 0 0 0 0 21 21 21 21 21 21 21 21 21 0 0 0 0 0 0 0 0 0 0 0 21 
21 0 0 0 0 0 0 0 0 0 0 0 0 0 0 0 0 0 0 0 0 0 0 22 22 22 22 22 21 
21 22 22 22 22 22 22 22 22 22 22 22 22 22 22 22 22 22 22 22 22 22 22 21 21 21 21 21 24 
21 21 21 21 21 21 21 21 21 21 21 21 21 21 21 21 21 21 21 21 21 21 21 21 21 21 21 21 21 
21 21 21 21 21 21 21 21 21 21 21 21 21 21 21 21 21 21 21 21 21 21 21 21 21 21 21 21 21 
